1111111111
1000000001
100C000001
1P00000E01
1111111111