111111111111111111
1P1110000C10000001
101000101110111101
1010111011C0100001
10100C100010101111
1000111110001000E1
111111111111111111